111111111111111111111111111111111111111
1                  2                  1
1               3  2                  1
1                  2                  1
1              11111                  1
1                                     1
1                                     1
1                                     1
1                 22111111111111111   1
1                 222                 1
1                 222                 1
1                 222                 1
1                 222                 1
1                 212                 1
1                 212                 1
1                 212                 1
1                 212                 1
1                 212                 1
1 5             222 122               1
11111111       222222               1
1              22  5  2                1
1              22 522              1
1              2222 2        1111111111
1              212222                51
1              21                     1
1              21                    1
1              21                     1
1              22                     1
1              22                     1
1              22                     1
1              22                     1
1   1111111111112                     1
1                                     1
1                                     1
1                                     1
1             111111                  1
1             2                       1
1             2       4               1
1             2                       1
111111111111111111111111111111111111111